FFF4D6FF
default

2222222222222222
22222221@@@@@@02
22222221@@.!@@02
22222221@@@@@@02
2222221111100112
2222221000200202
2222111000000002
2111100000000002
2000100000@@0002
200010000@11@002
20001200@121@.02
20.00000@11@0002
20!000000@@00002
200012000.000222
2000100000000222
2222222222222222